OOOOOOOOOO
OOOOOOOOOO
##########
#L   X X #
#  S   # #
#E   C C #
######   #
OOOOO#####
OOOOOOOOOO
OOOOOOOOOO
